111111111111111111111111111111111
100000000000000000000000000000001
1C0E01CC10C10C110C110C10C110C1001
10C0000CC000000000000000000000001
1010CC00000C00CC00CC00C00CC00C001
100P000C00C00C000C000C00C000C0001
101C00C0C000000011100001110000101
10C100C0C001100001110000111000001
101C00C0C000000000000000000000001
10C100C0C000100001100000110000001
101C00C0C000000000000000000000001
10CC00C0C000000000000000000000001
10CC00C0C111111111000001100000001
100100000000000000000000000000001
111111111111111111111111111111111