111111111111111111111111111111111
100000000000000000000000000000001
1C0E01CC10C10C110C110C10C110C10C1
10C0000CC000000000000000000000001
1010CC00000C00CC00CC00C00CC00C001
100P000C00C00C000C000C00C000C00C1
101C00C0C000000011100001110000111
10C100C0C001100001110000111000011
101C00C0C000000000000000000000001
10C100C0C000100001100000110000011
10CC00C0C000000000000000000000001
10CC00C0C000000000000000000000001
10CC00C0C111111111000001100000111
10C100C0C000100001100000110000011
111111111111111111111111111111111
