111111111111111111
1000P00001C00011C1
1010CC00000001C001
1000000C00100C0011
100E000C00100C0011
111111111111111111