111111111111111111
1P00C00C00C00C00C1
101111111111111101
100C011000100C0011
1E11000C10001C0011
111111111111111111