111111111111111111
10C00000C000C000C1
101110110011001101
10C0P000C000C000C1
101110110011001101
10C00000C000C00EC1
111111111111111111