111111111111111111
1P00C00C0EC00C00C1
1001000C10001C0001
101100CC10001C0001
111111111111111111