111111111111111111
10CP0000C000C0M0C1
10111011M01C001101
10111011M01C001101
10111011M01C001101
1E1000M00C00M0C001
111111111111111111