111111111111111111
10CP0000C000C0M0C1
10111011M011001101
10C00000C000C0M0C1
10111M110011001101
10C00000C00MC00EC1
111111111111111111